wwwwwwwww
w.......w
w.......w
w.@.....w
w.......w
wwww.wwww
w.......w
.M......w
w.......w
wwwwwwwww