wwwwwwwww
w.......w
w.......w
w.@.....w
w.......w
wwww.wwww
w.......w
........w
w..M....w
wwwwwwwww